6,6
% - - - - G
- - % % - -
% - % % - -
% - % % - %
% - % - - %
S - - - % %